0 1 2 9 0 1 2
3 4 5 9 3 4 5
6 7 8 9 6 7 8
9 9 9 9 9 9 9
0 1 2 9 0 1 2
3 4 5 9 3 4 5
6 7 8 9 6 7 8
0 1 2 9 0 1 2
3 4 5 9 3 4 5
6 7 8 9 6 7 8
9 9 9 9 9 9 9
0 1 2 9 0 1 2
3 4 5 9 3 4 5
6 7 8 9 6 7 8
0 1 2 9 0 1 2
3 4 5 9 3 4 5
6 7 8 9 6 7 8
9 9 9 9 9 9 9
0 1 2 9 0 1 2
3 4 5 9 3 4 5
6 7 8 9 6 7 8
